#reforence point coordinates
7	5	10
#the number of meter size cube
46
#sacle
5
#XYX dis
153	135	153	1
154	133	154	1
154	134	151	1
154	135	155	1
155	133	155	1
155	133	156	1
155	134	155	1
155	134	156	1
167	123	70	1
167	127	75	1
167	130	70	1
167	130	71	1
168	130	68	1
168	130	69	1
169	129	69	1
170	128	67	1
170	130	64	1
172	128	25	1
172	129	25	1
172	129	26	1
188	146	225	1
189	145	224	1
189	147	224	1
191	144	225	1
191	146	232	1
194	146	229	1
195	143	228	1
195	143	229	1
195	143	230	1
195	144	227	1
195	146	230	1
196	127	72	1
196	127	73	1
196	139	228	1
196	139	230	1
196	143	229	1
196	143	230	1
196	143	231	1
196	143	232	1
196	145	229	1
197	130	70	1
197	131	69	1
198	127	17	1
198	127	47	1
198	128	43	1
198	130	68	1
198	131	40	1
198	132	68	1
199	127	15	1
199	127	16	1
199	127	45	1
199	128	44	1
199	128	68	1
199	130	66	1
199	131	58	1
200	127	41	1
200	128	40	1
200	128	42	1
200	129	60	1
200	131	64	1
201	125	34	1
201	128	57	1
201	129	40	1
202	128	55	1
202	128	56	1
202	131	54	1
203	127	33	1
203	127	56	1
203	128	54	1
203	131	52	1
204	127	32	1
204	128	30	1
204	129	29	1
237	127	34	1
238	127	37	1
241	126	35	1
241	127	37	1
242	126	32	1
242	126	33	1
242	126	34	1
249	142	73	1
249	144	78	1
